# TYPES (KEYWORD1)
AnalogFilter	KEYWORD1
Filter	KEYWORD1
OffDelayTimer	KEYWORD1
OnDelayTimer	KEYWORD1
PulseTimer	KEYWORD1
SimplePacket	KEYWORD1
SimpleComm	KEYWORD1
Timer	KEYWORD1

# FUNCTIONS (KEYWORD2)
clear	KEYWORD2
getBool	KEYWORD2
getBuffer	KEYWORD2
getChar	KEYWORD2
getDataLength	KEYWORD2
getDestination	KEYWORD2
getDouble	KEYWORD2
getInt	KEYWORD2
getLong	KEYWORD2
getSource	KEYWORD2
getString	KEYWORD2
getUChar	KEYWORD2
getUInt	KEYWORD2
getULong	KEYWORD2
getType	KEYWORD2
receive	KEYWORD2
setData	KEYWORD2
setDestination	KEYWORD2
setSource	KEYWORD2
setType	KEYWORD2
send	KEYWORD2
startTrain	KEYWORD2
stopTrain	KEYWORD2
update	KEYWORD2

# CONSTANTS (LITERAL1)
